################################
#@                #  #         #
#  ####  ####  #  #  ####  #####
#     #  #  #  #               #
#  #######  #  #######  #  # ###
#           #  #     #  #  #   #
#  ####  ##########  #  ####   #
#     #     #     #     #  #   #
####  #  #  #  #  #  #  #  #  ##
#     #  #  #  #     #  #      #
#######  ##########  #  ########
#  #              #  #         #
#  ##########  ####  #  #  #   #
#        #  #  #  #  #  #  #   #
#  #######  #  #  ##########   #
#  #   #    #  #    #   #    ? #
#    #   #        #   #   #    #
################################
