[][][][][][][][][][][][][][][][][][][][][][][][][][][][][][][]
[]                                        []                []
[]                                        []                []
[]                                        []                []
[]                                        []                []
[]                                        []                []
[]                                        []      []        []
[]                @@                              []        []
[]                                                []        []
[]                                                []        []
[]                                                []        []
[]                                                []        []
[]                                                []        []
[]                                                []        []
[]                                                []        []
[]                                                []        []
[][][][][][][][][][][][][][][][][][][][][][][][][][][][][][][]
